Display of Maze!
	  0     1     2     3     4     5     6     7     8     9    10
	# # # # # # # # # # # # # # # # # # # # # # # # # # # # # # # # # 
0	# # # # # # # # # # # # # # # # # # # # # # # # # # # # # # # # # 
	# # # # # # # # # # # # # # # # # # # # # # # # # # # # # # # # # 
	# # # . . . . . . . . . # # # # # # # # # . . . # # # # # # # # # 
1	# # # . P . . . . . . . # # # # # # # # # . . . # # # # # # # # # 
	# # # . . . . . . . . . # # # # # # # # # . . . # # # # # # # # # 
	# # # . . . # # # . . . # # # . . . # # # . . . . . . . . . # # # 
2	# # # . . . # # # . . . # # # . . . # # # . . . . . . . . . # # # 
	# # # . . . # # # . . . # # # . . . # # # . . . . . . . . . # # # 
	# # # . . . # # # . . . # # # . . . # # # # # # # # # . . . # # # 
3	# # # . . . # # # . . . # # # . . . # # # # # # # # # . . . # # # 
	# # # . . . # # # . . . # # # . . . # # # # # # # # # . . . # # # 
	# # # # # # . . . . . . . . . . . . . . . # # # . . . . . . # # # 
4	# # # # # # . . . . . . . . . . . . . . . # # # . . . . . . # # # 
	# # # # # # . . . . . . . . . . . . . . . # # # . . . . . . # # # 
	# # # # # # # # # # # # . . . # # # . . . # # # . . . # # # # # # 
5	# # # # # # # # # # # # . . . # # # . . . # # # . . . # # # # # # 
	# # # # # # # # # # # # . . . # # # . . . # # # . . . # # # # # # 
	# # # . . . . . . . . . . . . # # # . . . . . . . . . . . . # # # 
6	# # # . . . . . . . . . . . . # # # . . . . . . . . . . . . # # # 
	# # # . . . . . . . . . . . . # # # . . . . . . . . . . . . # # # 
	# # # . . . # # # # # # # # # . . . # # # # # # # # # # # # # # # 
7	# # # . . . # # # # # # # # # . . . # # # # # # # # # # # # # # # 
	# # # . . . # # # # # # # # # . . . # # # # # # # # # # # # # # # 
	# # # . . . # # # . . . . . . . . . # # # . . . . . . . . . # # # 
8	# # # . . . # # # . . . . . . . . . # # # . . . . . . . . . # # # 
	# # # . . . # # # . . . . . . . . . # # # . . . . . . . . . # # # 
	# # # . . . . . . . . . # # # . . . . . . . . . # # # . . . # # # 
9	# # # . . . . . . . . . # # # . . . . . . . . . # # # . E . # # # 
	# # # . . . . . . . . . # # # . . . . . . . . . # # # . . . # # # 
	# # # # # # # # # # # # # # # # # # # # # # # # # # # # # # # # # 
10	# # # # # # # # # # # # # # # # # # # # # # # # # # # # # # # # # 
	# # # # # # # # # # # # # # # # # # # # # # # # # # # # # # # # # 

